"Sample","GC_to_AT","GC_to_CG","GC_to_TA","AT_to_GC","AT_to_CG","AT_to_TA","Total.snp","Coverage","Deletions","Insertions","Total.indels","Total_mutations"
"E400_POOLRET72_S275_L002",1,0,0,2,0,3,6,0.969513942,3,1,4,10
"E401_POOLRET73_S389_L003",0,0,0,0,0,5,5,0.749102134,1,1,2,7
"E402_POOLRET72_S359_L002",0,0,1,0,1,2,4,0.906996014,0,1,1,5
"E403_POOLRET73_S421_L003",1,0,0,0,0,4,5,0.828891157,0,1,1,6
"E404_POOLRET72_S280_L002",3,0,0,1,1,2,7,0.90378869,2,0,2,9
"E406_POOLRET73_S403_L003",0,0,0,0,0,3,3,0.929086268,3,1,4,7
"E407_POOLRET73_S467_L003",0,0,0,0,0,1,1,0.930587039,1,1,2,3
"E408_POOLRET72_S251_L002",2,0,0,0,0,3,5,0.970537142,2,1,3,8
"E410_POOLRET73_S390_L003",0,0,0,1,1,1,3,0.955425941,1,1,2,5
"E411_POOLRET72_S300_L002",0,0,0,1,1,4,6,0.823815823,3,1,4,10
"E414_POOLRET72_S368_L002",0,0,0,0,1,6,7,0.939628016,1,1,2,9
"E415_POOLRET72_S354_L002",0,0,0,0,0,2,2,0.920984082,0,0,0,2
"E416_POOLRET73_S423_L003",1,2,0,0,0,3,6,0.934357391,0,1,1,7
"E417_POOLRET73_S445_L003",0,0,0,0,0,3,3,0.758117095,2,1,3,6
"E418_POOLRET73_S500_L003",0,0,1,2,0,4,7,0.93812175,3,2,5,12
"E419_POOLRET73_S523_L003",0,0,0,1,1,2,4,0.869721808,0,1,1,5
"E420_POOLRET72_S210_L002",0,0,2,1,0,6,9,0.946096002,1,0,1,10
"E421_POOLRET73_S567_L003",0,0,0,0,0,5,5,0.865003681,0,1,1,6
"E422_POOLRET73_S561_L003",0,0,0,0,1,4,5,0.915884208,0,1,1,6
"E424_POOLRET72_S370_L002",1,0,2,0,0,1,4,0.935878096,1,2,3,7
"E425_POOLRET73_S563_L003",0,0,0,1,1,3,5,0.95143863,3,1,4,9
"E426_POOLRET72_S234_L002",0,0,0,1,0,1,2,0.9463586,0,1,1,3
"E429_POOLRET73_S533_L003",1,0,0,0,0,2,3,0.944404735,1,0,1,4
"E430_POOLRET72_S380_L002",0,0,0,0,0,2,2,0.956092432,1,0,1,3
"E431_POOLRET73_S454_L003",2,0,2,0,1,1,6,0.957279073,3,3,6,12
"E432_POOLRET72_S367_L002",0,0,1,1,0,0,2,0.777747294,0,0,0,2
"E433_POOLRET72_S200_L002",0,0,0,0,0,2,2,0.823912845,1,2,3,5
"E434_POOLRET72_S202_L002",0,1,0,0,0,5,6,0.777353911,0,1,1,7
"E435_POOLRET72_S378_L002",0,0,0,0,0,4,4,0.730347657,2,0,2,6
"E436_POOLRET72_S320_L002",0,0,0,0,1,1,2,0.961339145,1,1,2,4
"E437_POOLRET72_S315_L002",1,0,0,0,0,2,3,0.934819258,2,0,2,5
"E438_POOLRET72_S246_L002",0,0,0,1,1,7,9,0.971760877,4,0,4,13
"E439_POOLRET73_S425_L003",0,0,0,0,0,2,2,0.904403779,1,1,2,4
"E440_POOLRET73_S385_L003",0,1,0,0,0,1,2,0.913801812,2,0,2,4
"E441_POOLRET72_S363_L002",0,0,0,0,1,3,4,0.934730742,3,2,5,9
"E442_POOLRET72_S350_L002",1,0,0,1,0,4,6,0.944196851,2,0,2,8
"E444_POOLRET73_S442_L003",0,0,0,1,0,5,6,0.947487975,2,2,4,10
"E445_POOLRET73_S401_L003",0,0,1,1,0,5,7,0.942753166,2,0,2,9
"E447_POOLRET73_S430_L003",1,0,0,1,0,3,5,0.932121754,0,2,2,7
"E448_POOLRET73_S543_L003",0,0,0,0,1,3,4,0.953910072,3,1,4,8
"E451_POOLRET72_S252_L002",1,0,0,0,0,1,2,0.809340969,2,1,3,5
"E456_POOLRET72_S356_L002",0,0,0,2,1,2,5,0.939455929,3,3,6,11
"E457_POOLRET73_S512_L003",0,0,0,0,0,2,2,0.873491651,1,0,1,3
"E465_POOLRET72_S366_L002",0,1,0,1,0,4,6,0.761553992,0,2,2,8
"E467_POOLRET72_S201_L002",0,0,0,0,1,1,2,0.84430228,1,1,2,4
"E468_POOLRET73_S562_L003",0,0,0,0,0,0,0,0.711131273,2,0,2,2
"E469_POOLRET72_S383_L002",1,0,2,0,0,2,5,0.594894426,2,0,2,7
"E470_POOLRET72_S323_L002",2,1,0,0,1,3,7,0.959252082,1,1,2,9
"E471_POOLRET73_S483_L003",1,0,0,0,0,5,6,0.88022047,1,0,1,7
"E473_POOLRET72_S263_L002",2,0,2,1,1,2,8,0.833646279,1,1,2,10
"E474_POOLRET72_S266_L002",0,0,0,0,0,3,3,0.957659075,1,2,3,6
"E475_POOLRET72_S196_L002",2,0,0,0,0,4,6,0.683698052,0,1,1,7
"E476_POOLRET72_S362_L002",0,1,0,1,0,3,5,0.960460003,2,0,2,7
"E481_POOLRET72_S296_L002",0,0,1,0,0,2,3,0.90270285,1,1,2,5
"E482_POOLRET73_S468_L003",1,0,0,1,0,6,8,0.952264994,2,2,4,12
"E483_POOLRET72_S381_L002",1,0,0,0,3,8,12,0.954836469,3,5,8,20
"E485_POOLRET72_S372_L002",0,1,0,0,0,2,3,0.821394677,0,1,1,4
"E486_POOLRET73_S531_L003",0,0,1,0,2,2,5,0.896482615,5,1,6,11
"E488_POOLRET72_S195_L002",0,1,1,0,0,5,7,0.943427584,1,2,3,10
"E489_POOLRET73_S488_L003",0,0,0,0,0,3,3,0.812021732,0,1,1,4
"E490_POOLRET72_S288_L002",0,0,0,1,0,1,2,0.896029862,0,0,0,2
"E491_POOLRET72_S214_L002",1,0,0,0,0,2,3,0.883829115,1,2,3,6
"E492_POOLRET73_S508_L003",0,1,1,0,0,5,7,0.861027409,3,0,3,10
"E493_POOLRET72_S227_L002",1,0,1,0,0,5,7,0.972312986,2,0,2,9
"E495_POOLRET72_S211_L002",0,1,0,1,1,6,9,0.92042989,1,2,3,12
"E496_POOLRET73_S535_L003",0,0,0,0,1,1,2,0.708326635,3,0,3,5
"E497_POOLRET73_S392_L003",1,0,0,0,1,5,7,0.941820716,3,1,4,11
"E499_POOLRET72_S231_L002",1,0,0,1,0,1,3,0.815676823,1,0,1,4
"H7GWFDSX7_E405_POOLRET74",1,0,0,0,1,3,5,0.975882094,3,6,9,14
"H7GWFDSX7_E412_POOLRET74",0,0,0,0,1,2,3,0.945762437,1,0,1,4
"H7GWFDSX7_E413_POOLRET74",0,0,0,0,0,4,4,0.9053391,0,2,2,6
"H7GWFDSX7_E423_POOLRET74",0,0,0,2,1,5,8,0.958716317,0,2,2,10
"H7GWFDSX7_E427_POOLRET74",0,0,0,0,2,5,7,0.912185432,3,0,3,10
"H7GWFDSX7_E428_POOLRET74",0,0,0,0,0,1,1,0.976327498,4,0,4,5
"H7GWFDSX7_E443_POOLRET74",0,0,0,1,1,4,6,0.976935547,1,3,4,10
"H7GWFDSX7_E446_POOLRET74",0,1,0,1,0,5,7,0.976929045,3,1,4,11
"H7GWFDSX7_E449_POOLRET74",1,0,0,0,0,2,3,0.809494101,2,0,2,5
"H7GWFDSX7_E450_POOLRET74",1,0,2,1,0,3,7,0.974346263,4,0,4,11
"H7GWFDSX7_E452_POOLRET74",1,0,0,0,0,1,2,0.903529173,2,2,4,6
"H7GWFDSX7_E453_POOLRET74",0,1,0,1,0,3,5,0.909042972,4,4,8,13
"H7GWFDSX7_E454_POOLRET74",0,0,0,0,0,1,1,0.825638363,2,3,5,6
"H7GWFDSX7_E455_POOLRET74",0,0,0,0,3,6,9,0.932200219,1,2,3,12
"H7GWFDSX7_E458_POOLRET74",0,0,0,0,0,2,2,0.568417187,2,1,3,5
"H7GWFDSX7_E459_POOLRET74",0,0,0,0,1,4,5,0.952239457,3,1,4,9
"H7GWFDSX7_E460_POOLRET74",0,0,0,1,0,4,5,0.976029372,4,2,6,11
"H7GWFDSX7_E461_POOLRET74",0,0,0,0,0,9,9,0.953559715,1,1,2,11
"H7GWFDSX7_E462_POOLRET74",1,0,0,1,0,8,10,0.919012479,1,3,4,14
"H7GWFDSX7_E463_POOLRET74",1,0,0,1,2,3,7,0.976506675,2,2,4,11
"H7GWFDSX7_E464_POOLRET74",0,0,0,1,1,5,7,0.952224908,1,0,1,8
"H7GWFDSX7_E466_POOLRET74",0,0,0,2,1,6,9,0.867845073,3,1,4,13
"H7GWFDSX7_E472_POOLRET74",0,0,0,0,0,3,3,0.973469005,1,1,2,5
"H7GWFDSX7_E477_POOLRET74",1,0,0,0,0,4,5,0.953206427,6,1,7,12
"H7GWFDSX7_E478_POOLRET74",0,0,0,1,0,5,6,0.972835898,5,1,6,12
"H7GWFDSX7_E479_POOLRET74",0,1,1,1,0,3,6,0.937390255,3,1,4,10
"H7GWFDSX7_E480_POOLRET74",1,0,0,2,0,2,5,0.882051595,1,0,1,6
"H7GWFDSX7_E484_POOLRET74",0,0,0,0,0,2,2,0.951846582,1,1,2,4
"H7GWFDSX7_E487_POOLRET74",1,0,0,1,0,1,3,0.852438727,3,1,4,7
"H7GWFDSX7_E494_POOLRET74",0,0,0,0,0,10,10,0.972975279,2,0,2,12
"H7GWFDSX7_E498_POOLRET74",0,0,0,0,0,7,7,0.933806728,1,1,2,9
"G201_POOLRET73_S509_L003",0,0,0,0,0,3,3,0.749102134,1,1,2,5
"G202_POOLRET73_S446_L003",0,0,0,0,0,4,4,0.906996014,1,2,3,7
"G203_POOLRET72_S273_L002",1,0,1,0,0,2,4,0.828891157,0,0,0,4
"G204_POOLRET73_S504_L003",1,0,0,1,1,3,6,0.90378869,1,1,2,8
"G206_POOLRET73_S465_L003",0,0,0,0,0,5,5,0.929086268,2,2,4,9
"G209_POOLRET72_S352_L002",0,0,0,1,0,7,8,92,4,2,6,14
"G210_POOLRET73_S494_L003",0,0,0,0,1,2,3,0.955425941,1,0,1,4
"G211_POOLRET73_S395_L003",0,1,0,1,0,1,3,0.823815823,1,0,1,4
"G212_POOLRET73_S396_L003",2,0,0,0,1,0,3,0.945762437,0,1,1,4
"G213_POOLRET72_S193_L002",1,0,0,0,2,2,5,0.9053391,1,1,2,7
"G214_POOLRET72_S332_L002",0,0,0,1,0,1,2,0.939628016,2,1,3,5
"G215_POOLRET72_S264_L002",1,0,0,0,2,2,5,0.920984082,0,1,1,6
"G216_POOLRET73_S502_L003",0,0,1,0,0,2,3,0.934357391,0,0,0,3
"G217_POOLRET73_S397_L003",1,0,0,0,0,0,1,0.758117095,1,0,1,2
"G218_POOLRET73_S521_L003",0,0,0,0,0,2,2,0.93812175,0,1,1,3
"G219_POOLRET73_S574_L003",0,0,0,0,1,1,2,0.869721808,0,0,0,2
"G221_POOLRET72_S308_L002",0,0,0,0,0,6,6,0.865003681,1,2,3,9
"G222_POOLRET72_S297_L002",0,0,0,0,1,1,2,0.915884208,1,4,5,7
"G223_POOLRET73_S451_L003",1,1,0,0,1,2,5,0.958716317,0,1,1,6
"G224_POOLRET73_S441_L003",0,0,0,0,0,3,3,0.935878096,0,0,0,3
"G226_POOLRET72_S258_L002",0,0,1,1,0,0,2,0.9463586,0,2,2,4
"G227_POOLRET72_S377_L002",0,0,0,1,0,4,5,0.912185432,1,2,3,8
"G229_POOLRET73_S539_L003",1,0,1,0,0,1,3,0.944404735,1,0,1,4
"G230_POOLRET73_S458_L003",0,0,0,0,0,0,0,0.956092432,0,0,0,0
"G231_POOLRET73_S457_L003",0,0,0,0,1,1,2,0.957279073,1,1,2,4
"G232_POOLRET73_S558_L003",0,0,0,0,0,4,4,0.777747294,1,0,1,5
"G233_POOLRET72_S242_L002",1,0,0,0,2,2,5,0.823912845,0,1,1,6
"G234_POOLRET72_S215_L002",0,0,0,0,0,0,0,0.777353911,2,0,2,2
"G235_POOLRET73_S570_L003",1,0,0,0,1,0,2,0.730347657,0,1,1,3
"G237_POOLRET72_S307_L002",1,0,0,2,1,2,6,0.934819258,0,1,1,7
"G239_POOLRET73_S444_L003",0,0,0,0,0,3,3,0.904403779,0,0,0,3
"G241_POOLRET73_S452_L003",1,0,0,0,0,2,3,0.934730742,3,0,3,6
"G242_POOLRET72_S286_L002",2,0,0,1,0,0,3,0.944196851,1,1,2,5
"G244_POOLRET73_S408_L003",0,0,0,0,0,2,2,0.947487975,1,3,4,6
"G245_POOLRET73_S519_L003",1,0,0,0,0,3,4,0.942753166,0,0,0,4
"G247_POOLRET73_S530_L003",0,0,0,0,0,0,0,0.932121754,0,0,0,0
"G248_POOLRET73_S387_L003",1,0,0,0,0,2,3,0.953910072,3,0,3,6
"G249_POOLRET72_S198_L002",0,0,0,0,0,2,2,0.809494101,1,0,1,3
"G252_POOLRET73_S481_L003",0,1,1,1,0,3,6,0.903529173,1,0,1,7
"G253_POOLRET73_S431_L003",1,0,0,0,1,0,2,0.909042972,1,1,2,4
"G254_POOLRET73_S447_L003",0,0,0,0,0,2,2,0.825638363,0,0,0,2
"G255_POOLRET72_S237_L002",0,0,0,0,0,5,5,0.932200219,0,0,0,5
"G257_POOLRET73_S540_L003",0,0,0,1,1,2,4,0.873491651,3,1,4,8
"G258_POOLRET73_S473_L003",1,0,0,0,0,2,3,0.568417187,1,2,3,6
"G259_POOLRET73_S428_L003",1,0,0,1,0,1,3,0.952239457,1,1,2,5
"G261_POOLRET72_S254_L002",1,0,0,1,0,2,4,0.953559715,1,1,2,6
"G262_POOLRET73_S394_L003",0,0,0,1,0,2,3,0.919012479,2,0,2,5
"G264_POOLRET73_S470_L003",0,0,0,0,0,1,1,0.952224908,1,1,2,3
"G265_POOLRET72_S298_L002",1,0,0,0,1,0,2,0.761553992,2,0,2,4
"G266_POOLRET73_S407_L003",0,0,0,0,0,5,5,0.867845073,1,1,2,7
"G268_POOLRET72_S342_L002",2,0,1,0,0,3,6,0.711131273,1,1,2,8
"G269_POOLRET73_S573_L003",0,0,0,0,0,2,2,0.594894426,0,0,0,2
"G270_POOLRET72_S345_L002",0,0,2,0,0,0,2,0.959252082,0,0,0,2
"G271_POOLRET73_S413_L003",0,0,0,0,0,0,0,0.88022047,1,0,1,1
"G273_POOLRET73_S525_L003",0,0,1,0,0,2,3,0.833646279,0,0,0,3
"G274_POOLRET72_S271_L002",0,0,0,0,0,0,0,0.957659075,0,0,0,0
"G277_POOLRET72_S364_L002",0,1,0,0,0,2,3,0.953206427,2,2,4,7
"G279_POOLRET72_S305_L002",0,1,0,0,0,2,3,0.937390255,0,1,1,4
"G280_POOLRET73_S487_L003",0,0,1,0,0,3,4,0.882051595,1,0,1,5
"G281_POOLRET73_S422_L003",0,0,0,0,0,2,2,0.90270285,0,0,0,2
"G282_POOLRET72_S248_L002",0,0,0,1,1,5,7,0.952264994,2,0,2,9
"G283_POOLRET73_S427_L003",1,0,0,0,1,3,5,0.954836469,1,0,1,6
"G284_POOLRET73_S463_L003",0,0,0,0,0,0,0,0.951846582,1,2,3,3
"G285_POOLRET72_S325_L002",1,0,0,0,1,3,5,0.821394677,0,0,0,5
"G286_POOLRET73_S548_L003",0,0,0,1,0,2,3,0.896482615,0,1,1,4
"G287_POOLRET73_S549_L003",1,0,0,0,0,0,1,0.852438727,2,0,2,3
"G289_POOLRET73_S537_L003",1,0,0,0,0,1,2,0.812021732,0,2,2,4
"G290_POOLRET73_S426_L003",0,0,0,0,0,0,0,0.896029862,1,0,1,1
"G295_POOLRET73_S434_L003",0,1,0,2,0,2,5,0.92042989,2,1,3,8
"G296_POOLRET73_S386_L003",0,0,1,1,1,1,4,0.708326635,0,1,1,5
"G297_POOLRET72_S331_L002",0,0,0,0,0,1,1,0.941820716,1,1,2,3
"G298_POOLRET72_S306_L002",0,0,0,0,0,3,3,0.933806728,1,1,2,5
"G299_POOLRET72_S349_L002",1,0,0,0,0,1,2,0.815676823,1,1,2,4
"H7GWFDSX7_G200_POOLRET74",0,0,0,0,0,3,3,0.969513942,0,1,1,4
"H7GWFDSX7_G205_POOLRET74",1,0,0,1,0,2,4,0.975882094,4,2,6,10
"H7GWFDSX7_G207_POOLRET74",0,1,1,0,1,0,3,0.930587039,3,2,5,8
"H7GWFDSX7_G208_POOLRET74",0,1,0,0,0,0,1,0.970537142,4,0,4,5
"H7GWFDSX7_G220_POOLRET74",0,1,1,1,0,2,5,0.946096002,4,1,5,10
"H7GWFDSX7_G225_POOLRET74",0,0,0,1,0,4,5,0.95143863,3,3,6,11
"H7GWFDSX7_G228_POOLRET74",0,0,0,1,0,1,2,0.976327498,1,4,5,7
"H7GWFDSX7_G236_POOLRET74",0,0,0,0,0,0,0,0.961339145,3,0,3,3
"H7GWFDSX7_G238_POOLRET74",0,1,0,0,0,3,4,0.971760877,1,1,2,6
"H7GWFDSX7_G240_POOLRET74",0,0,0,0,0,4,4,0.913801812,1,0,1,5
"H7GWFDSX7_G243_POOLRET74",0,0,0,0,0,1,1,0.976935547,0,1,1,2
"H7GWFDSX7_G246_POOLRET74",0,0,0,0,0,0,0,0.976929045,1,0,1,1
"H7GWFDSX7_G250_POOLRET74",1,0,1,1,0,0,3,0.974346263,0,1,1,4
"H7GWFDSX7_G251_POOLRET74",0,0,0,0,0,7,7,0.809340969,1,1,2,9
"H7GWFDSX7_G256_POOLRET74",0,0,0,0,0,4,4,0.939455929,1,1,2,6
"H7GWFDSX7_G260_POOLRET74",1,2,0,0,0,3,6,0.976029372,0,0,0,6
"H7GWFDSX7_G263_POOLRET74",1,0,0,3,1,2,7,0.976506675,1,2,3,10
"H7GWFDSX7_G267_POOLRET74",0,0,0,0,1,4,5,0.84430228,1,1,2,7
"H7GWFDSX7_G272_POOLRET74",0,0,0,0,0,2,2,0.973469005,0,0,0,2
"H7GWFDSX7_G275_POOLRET74",0,0,0,2,0,0,2,0.683698052,0,0,0,2
"H7GWFDSX7_G276_POOLRET74",0,0,0,0,0,4,4,0.960460003,1,1,2,6
"H7GWFDSX7_G278_POOLRET74",0,0,0,2,0,3,5,0.972835898,1,0,1,6
"H7GWFDSX7_G288_POOLRET74",0,0,0,0,1,3,4,0.943427584,2,1,3,7
"H7GWFDSX7_G291_POOLRET74",0,0,0,1,0,3,4,0.883829115,2,0,2,6
"H7GWFDSX7_G292_POOLRET74",0,0,0,0,2,2,4,0.861027409,0,2,2,6
"H7GWFDSX7_G293_POOLRET74",0,0,0,1,0,4,5,0.972312986,3,1,4,9
"H7GWFDSX7_G294_POOLRET74",0,0,0,0,1,2,3,0.972975279,1,1,2,5
